{
  "mapName": "Dungeon Level 1",
  "gridWidth": 32,
  "gridHeight": 16,
  "playerSpawns": [ { "x": 2, "y": 2 } ],
  "tileIDs": [
[23,23,23,23,23,23,23,23,23,23,23,23,23,23,23,23,23,23,23,23,23,23,23,23,23,23,23,23,23,23,23,23],
[23,1,1,1,1,23,0,0,0,0,23,1,1,1,1,1,1,23,0,0,0,0,23,1,1,1,1,1,1,1,23,23],
[23,1,1,1,1,23,0,0,0,0,23,1,1,1,1,1,1,23,0,0,0,0,23,1,1,1,1,1,1,1,23,23],
[23,1,1,1,1,23,0,0,0,0,23,1,1,1,1,1,1,23,0,0,0,0,23,1,1,1,1,1,1,1,23,23],
[23,1,1,1,1,23,1,1,1,1,1,1,1,1,1,1,1,23,1,1,1,1,1,1,1,1,1,1,1,1,23,23],
[23,1,1,1,1,23,1,1,1,1,1,1,1,1,1,1,1,23,1,1,1,1,1,1,1,1,1,1,1,1,23,23],
[23,23,23,23,23,23,1,1,1,1,1,1,1,1,1,1,1,23,1,1,1,1,1,1,1,1,1,1,1,1,23,23],
[0,0,0,0,0,0,1,1,1,1,1,1,1,1,1,1,1,23,1,1,1,1,1,1,1,1,1,1,1,1,23,23],
[0,0,0,0,0,0,23,23,23,23,23,23,23,23,23,23,23,23,23,23,23,23,23,23,23,23,23,23,23,23,23,23],
[0,0,0,0,0,0,23,1,1,1,1,1,1,1,1,1,1,23,1,1,1,1,1,1,1,1,1,1,1,1,23,23],
[23,23,23,23,23,23,23,1,1,1,1,1,1,1,1,1,1,23,1,1,1,1,1,1,1,1,1,1,1,1,23,23],
[23,1,1,1,1,1,1,1,1,1,1,1,1,1,1,1,1,23,1,1,1,1,1,1,1,1,1,1,1,1,23,23],
[23,1,1,1,1,1,1,1,1,1,1,1,1,1,1,1,1,23,1,1,1,1,1,1,1,1,1,1,1,1,23,23],
[23,1,1,1,1,1,1,1,1,1,1,1,1,1,1,1,1,23,1,1,1,1,1,1,1,1,1,1,1,1,23,23],
[23,23,23,23,23,23,23,23,23,23,23,23,23,23,23,23,23,23,23,23,23,23,23,23,23,23,23,23,23,23,23,23],
[0,0,0,0,0,0,0,0,0,0,0,0,0,0,0,0,0,0,0,0,0,0,0,0,0,0,0,0,0,0,0,0]
],
  "metadata": {}
}